######..........
######..........
######..........
................
................
................
................
................
................
................
................
................
................
..........######
..........######
..........######