................
..###......###..
..###......###..
..###......###..
................
................
................
................
................
................
................
................
.....######.....
....########....
..############..
................