################
#..............#
................
................
......####......
.....######.....
......####......
................
................
................
................
......####......
......####......
......####......
##....####....##
##....####....##
