...................#
.....###########....
...............#....
...............#....
....................
....................
....................
....................
....................
.........###........
....................
.........#..........
....................
....................
....................
....................
....................
....................
....................
#..................#